右侧乙状窦后入路听神经瘤切除术+脑脊液切口瘘修补术+颅骨骨瓣修补术+颅内神经刺激器置入术(颅内压传感器探头)	颅内压监测##颅骨瓣形成##脑脊液切口漏修补术##经乙状窦后入路听神经瘤切除术
抗青光眼手术+激光小梁成形术[ALP、KLP]	氪激光小梁成形术[KLP]##氩激光小梁成形术[ALP]
右眼白内障超声乳化抽吸术+人工晶体置入术	置入人工晶状体##白内障晶状体乳化和抽吸
尿道扩张+输尿管镜检+经尿道激光碎石术+双J管置换术	经尿道输尿管/肾盂激光碎石术##输尿管镜检查##输尿管支架置换术##尿道扩张
(输尿管（或尿道）镜左侧)输尿管口扩张+输尿管镜下钬激光碎石术+输尿管镜下取石术+输尿管D-J管置入术((56.9101+56.0006+56.0001+56.9201))	经尿道输尿管/肾盂激光碎石取石术##经尿道输尿管支架置入术##输尿管扩张术
尿道口囊肿切除术+包皮环切术	尿道口病损切除术##包皮环切术
肾同种异体移植术+异体供肾取肾术+移植肾修整术+膀胱瓣代输尿管术	移植肾修补术##膀胱瓣代输尿管术##肾异体移植术##供肾取肾术
腹腔镜下肾部分切除术+肾裂伤缝合术（左侧）	肾裂伤缝合术##腹腔镜下肾部分切除术
经皮肾镜碎石取石术（左侧）	经皮肾镜碎石术（PCNL）##经皮肾镜取石术
右输尿管镜检+气压弹道碎石+双J管植入术	经尿道输尿管/肾盂气压弹道碎石术##经尿道输尿管支架置入术##输尿管镜检查
尿道扩张+右侧输尿管支架管置入术	经尿道输尿管支架置入术##尿道扩张
膝关节镜检，腘窝囊肿切除。	关节镜膝关节检查##腘窝囊肿切除术
鼻内镜下腺样体吸割术+双侧鼓室探查术+双侧鼓膜置管术	鼓膜切开术伴置管##鼓室探查术##内镜下腺样体切除术
TURP+膀胱穿刺造瘘术	经尿道前列腺切除术（TURP）##经皮膀胱造口术
右输尿管镜碎石取石术+双J管置入术	经尿道输尿管和肾盂梗阻去除##经尿道输尿管支架置入术
左侧输尿管镜取石术+D-J管留置术	经尿道输尿管/肾盂取石术##经尿道输尿管支架置入术
输尿管镜检查术+输尿管双“J”管取出术((56.3101+97.6201))	输尿管镜检查##输尿管双“J”管取出术
双侧脑深部刺激电极置入术	脑深部电极置入术##颅神经刺激脉冲发生器植入
输尿管镜下钬激光碎石术+输尿管扩张术+DJ管置入术	经尿道输尿管支架置入术##输尿管扩张术##经尿道输尿管/肾盂激光碎石术
腮腺肿瘤（肿块）切除术+面神经解剖术((26.2910+04.0701))	面神经解剖术##腮腺病损切除术
右肩关节镜检查+肩袖修补术+肩关节松解术	关节镜肩关节检查##关节镜肩关节松解术##回旋肌环带修补术
左侧经皮肾镜碎石取石	经皮肾镜碎石术（PCNL）##经皮肾镜取石术
亲体肾移植术	肾异体移植术##与供者有血缘关系的活体移植
输尿管镜检查术+尿道扩张术。	输尿管镜检查##尿道扩张
右眼PHACO＋IOL植入术	置入人工晶状体##白内障晶状体乳化和抽吸
开颅颅内动脉瘤夹闭＋颅骨成型术	颅成形术##钳夹动脉瘤
(右侧)肾部分切除术+肾周围粘连松解	肾周围粘连松解术##部分肾切除术
输尿管镜检查术+经皮肾穿刺造瘘术	输尿管镜检查##肾造口术
胫骨骨折切开复位钢板内固定术+腓骨骨折切开复位钢板内固定术	胫骨骨折切开复位内固定术##腓骨骨折切开复位内固定术
左肾盂成形术，左肾盂切开取石术	肾盂切开取石术##肾盂成形术
后入路腰椎间盘切除术+椎间植骨融合内固定术（枢法模）	腰椎椎体间融合术，后入路##腰椎间盘切除术
经改良扩大迷路径路左侧听神经瘤摘除+腹部取脂术	经迷路内听道听神经瘤切除术##自体脂肪移植术
右侧输尿管镜检+右侧输尿管支架植入术	输尿管镜检查##输尿管导管插入术
右肩关节镜下肩锋成形术+肩袖修补术+肱二头肌长头肌腱移位固定术	肌腱转移术##肩峰成形术##回旋肌环带修补术
经尿道膀胱肿瘤电切术+前列腺穿刺活检术	经尿道膀胱病损切除术##闭合性[经皮][针吸]前列腺活组织检查
鼻内镜下增殖体等离子切除术(28.3)+耳内镜下双耳鼓膜穿刺术	鼓膜穿刺术##内镜下腺样体切除术
右手多指切除术+拇指对掌功能重建术	拇对掌肌功能重建术##上肢截断术
右尺神经松解前移术	尺神经松解术##尺神经移位术
右侧经皮肾镜碎石+DJ管留置+右肾造瘘术	经皮肾镜碎石术（PCNL）##经皮肾镜输尿管支架置入术##肾造口术
脊髓硬膜外病变切除术+脊髓和神经根粘连松解术+椎管扩大减压术+术中电生理监测	椎管结构探查术和减压术##手术中神经生理监测##脊髓神经根粘连松解术##硬脊膜外病损切除术
胰体尾脾切除术	胰体尾切除术##全脾切除术
双侧正中神经探查、腕管松解术    Exploration of medial nerve and release of the bilateral carpal tunnel	腕管松解术##正中神经探查术
左眼小梁切除+虹膜周切+前房成形术。	前房成形术##外路小梁切除术##虹膜周边切除术
子宫下段剖宫产术+双侧子宫动脉上行支结扎术	低位子宫下段剖宫产##子宫动脉结扎术
腹腔镜下左肾部分切除术+肠粘连松解术	肠粘连松解术##腹腔镜下肾部分切除术
左腮腺肿物切除术+面神经解剖术+补片修补术	面神经解剖术##腮腺病损切除术##腮腺脱细胞异体真皮补片修补术
左股骨截骨术	股骨缩短术##股骨内固定术
经腹子宫下段剖宫产术+盆腔粘连松解术	低位子宫下段剖宫产##盆腔粘连松解术
阴茎矫直+部分尿道成形术	尿道成形术##阴茎矫直术
右眼硅油取出联合人工晶体II期植入术	玻璃体硅油取出术##眼内人工晶状体二期置入
右下颌骨囊肿开窗取病理术	颌骨活组织检查术##颌骨囊肿开窗引流术
左侧后颅窝硬膜外血肿清除术，有创颅内压监测置入术	颅内压监测##颅后窝血肿清除术
腹腔镜根治性全膀胱切除+原位回肠新膀胱术	腹腔镜下膀胱根治切除术##小肠段分离术##可控回肠膀胱术
内镜辅助下腮腺浅叶切除+面神经解剖术	面神经解剖术##腮腺叶切除术
（左侧）乳房部分切除术+（左侧）皮瓣转移术	乳腺部分切除术##带蒂皮瓣或皮瓣移植
左侧输尿管软镜检查碎石+左输尿管内双J管更换术	经尿道输尿管和肾盂梗阻去除##输尿管支架置换术
双侧脑深部电极植入术	脑深部电极置入术##颅神经刺激脉冲发生器植入
(膀胱镜)经尿道膀胱病损电切术+膀胱灌注(57.4901+96.4901)	经尿道膀胱病损切除术##膀胱灌注
脑深部电刺激术	脑深部电极置入术##颅神经刺激脉冲发生器植入
腮腺肿物及部分腺体切除术	腮腺部分切除术##腮腺病损切除术
左胫骨平台骨折切开复位植骨内固定术	胫骨植骨术##胫骨骨折切开复位内固定术
输尿管镜检查、输尿管镜下左侧输尿管结石取石术及输尿管内支架管置入术	经尿道输尿管支架置入术##经尿道输尿管和肾盂梗阻去除##输尿管镜检查
L4/5腰椎斜前路椎体间融合术	2-3个椎骨融合或再融合##腰椎椎体间融合术，前入路
左侧睾丸扭转复位术+双侧睾丸固定术	睾丸扭转复位术##睾丸固定术
双侧腕管切开减压+正中神经松解	腕管松解术##正中神经松解术
左锁骨下动脉球囊扩张+支架置入术	锁骨下动脉球囊血管成形术##锁骨下动脉支架置入术
1、左股骨粗隆骨折ORIF2、股骨头钻孔减压	股骨骨折切开复位内固定术##股骨减压术
B超引导下经直肠前列腺穿刺活检术+插入导尿管	经直肠前列腺穿剌活组织检查##留置导尿管的置入术
右肘部尺神经松解前置术	尺神经松解术##尺神经移位术
(输尿管（或尿道）镜左侧)输尿管镜下取石术+(输尿管（或尿道）镜左侧)输尿管镜下钬激光碎石术+(输尿管（或尿道）镜左侧)输尿管镜检查术+(输尿管（或尿道）镜左侧)输尿管扩张术((56.0001+56.0006+56.3101+59.8001))	经尿道输尿管/肾盂激光碎石取石术##输尿管镜检查##输尿管扩张术
腰椎后路间盘摘除Wallis置入术	腰椎间盘切除术##棘突装置的置入
根治性全膀胱切除+回肠膀胱术+阑尾切除术	小肠段分离术##根治性膀胱切除术##可控回肠膀胱术##阑尾切除术
腹腔镜辅助阴道子宫切除术（LAVH）+腹腔镜下双侧输卵管卵巢切除术	腹腔镜辅助阴道子宫切除术(LAVH)##腹腔镜双侧卵巢和输卵管切除术
左髋关节切开复位＋左髋salter骨盆截骨＋左股骨旋转截骨术	骨盆楔形截骨术##髋脱位开放性复位术##股骨楔形骨切开术
下颌骨骨折切开复位内固定术+髁状突骨折切开复位内固定术	髁状突骨折切开复位内固定术##下颌骨骨折切开复位内固定术
L4-5神经根松解、棘突间融合术	2-3个椎骨融合或再融合##腰椎后柱融合术，后入路##脊神经根减压术
经尿道前列腺电切术+经尿道绿激光前列腺汽化术	经尿道前列腺切除术（TURP）##经尿道(超声)激光诱导前列腺切除术(TULIP)
L45后入路腰椎间盘切除术+椎骨植骨术+后入路腰椎融合术	2-3个椎骨融合或再融合##腰椎椎体间融合术，后入路##腰椎间盘切除术
封堵器辅助左侧输尿管镜钬激光碎石术及双J管置入术	经尿道输尿管支架置入术##经尿道输尿管/肾盂激光碎石术
尿道扩张+输尿管支架管置入术	经尿道输尿管支架置入术##尿道扩张
左侧腮腺肿块切除+浅叶切除+面神经松解减压术	面神经减压术##腮腺病损切除术
异体肾移植术+修肾术	移植肾修补术##肾异体移植术
右肾探查，右肾切除术	肾探查术##单侧肾切除术
右侧枕角穿刺脑室腹腔分流术	侧脑室腹腔内分流术##脑池穿刺
左侧输尿管切开取石术及输尿管内支架管置入术	输尿管切开取石术##输尿管导管插入术
左全髋关节置换术+内固定取出术	骨空隙骨水泥填充术##全髋关节置换
肝动脉化疗栓塞术	经导管肝动脉栓塞术##动脉化疗栓塞
经尿道输尿管镜激光碎石术+输尿管支架置入术	经尿道输尿管支架置入术##经尿道输尿管/肾盂激光碎石术
髁状突骨折+颏部骨折切开复位内固定	髁状突骨折切开复位内固定术##下颌骨骨折开放性复位术
宫腔镜下子宫内膜息肉电切术加曼月乐环放置术	子宫内避孕装置置入##宫腔镜子宫内膜病损切除术
经尿道膀胱肿瘤电切术+包皮环切术	经尿道膀胱病损切除术##包皮环切术
尿道镜下尿道狭窄电切术+经尿道前列腺切除术[TURP手术]	经尿道前列腺切除术（TURP）##经尿道尿道狭窄电切术
左侧基底节区血肿清除+去骨瓣减压术	颅骨去骨瓣减压术##脑血肿切开引流术
阴茎矫直术+尿道成形术	尿道成形术##阴茎矫直术
1.胸腔镜下左侧膈肌折叠术；2.左侧胸腔闭式引流	胸腔镜膈肌折叠术##胸腔闭式引流术
右眼玻璃体腔药物注射术+前房穿刺术	玻璃体药物注射术##前房穿刺术
根治性膀胱切除，盆腔淋巴清扫，回肠膀胱术	腹腔镜下膀胱根治切除术##小肠段分离术##可控回肠膀胱术##盆腔淋巴结清扫术
等离子TURP+尿道扩张	经尿道前列腺切除术（TURP）##尿道扩张
左侧输尿管镜检查+逆行造影术	输尿管镜检查##逆行输尿管造影
经鼻蝶入路鞍区病损切除术+脑脊液鼻瘘修补术	鞍区病损切除术##脑脊液鼻漏修补术
左侧睾丸下降固定术+包皮环切术	包皮环切术##睾丸固定术
左侧输尿管镜检查、扩张、输尿管D-J管置入术。	经尿道输尿管支架置入术##输尿管镜检查##输尿管扩张术
1腹腔镜下输尿管切开取石术（左）2输尿管周围粘连松解术3输尿管支架置入术	腹腔镜下输尿管切开取石术##腹腔镜下输尿管周围粘连松解术##输尿管导管插入术
肝动脉栓塞化疗术	经导管肝动脉栓塞术##动脉化疗栓塞
经尿道前列腺电切术+双侧睾丸切除术	经尿道前列腺切除术（TURP）##同一次手术中去除双侧睾丸
双侧下颌升支矢状劈开截骨术+LefortI型截骨术	下颌骨截骨成形术##上颌LefortⅠ型截骨成形术
(关节镜右侧)肩关节镜下岗上肌腱修补术+(关节镜右侧)肩关节镜下肩锋成形术+(关节镜右侧)关节镜下肱二头肌腱固定术+(关节镜右侧)肩关节镜检查	冈上肌修补术##关节镜肩关节检查##肩峰成形术##肌腱固定术
右经皮肾镜钬激光碎石+双J管置入术	经皮肾镜激光碎石术##经皮肾镜输尿管支架置入术
白内障超声乳化术+IOL植入术OD	置入人工晶状体##白内障晶状体乳化和抽吸
左膝关节镜检+滑膜切除+针刀松解术	关节镜膝关节检查##关节镜膝关节滑膜切除术##膝关节松解术
输尿管镜检查+拔输尿管支架管	输尿管镜检查##去除输尿管造口导管和输尿管导管
左侧PCNL，输尿管内D-J管置入术	经皮肾镜碎石术（PCNL）##经皮肾镜输尿管支架置入术
面神经、三叉神经微血管减压术+神经梳理术+术中电生理监测	手术中神经生理监测##三叉神经微血管减压术##颅和周围神经的破坏术##面神经微血管减压术
右肘尺神经松解前移术	尺神经松解术##尺神经移位术
腰椎后入路椎间孔镜下L5/S1椎间盘切除、神经根管减压术	内镜下腰椎间盘切除术##脊神经根减压术
供肾修补+同种异体肾移植术（DCD供肾）+移植肾输尿管支架置入术	移植肾修补术##经尿道输尿管支架置入术##肾异体移植术
腹腔镜膀胱根治性切除术+腹腔镜盆腔淋巴结切除术+回肠膀胱术	腹腔镜下膀胱根治切除术##小肠段分离术##可控回肠膀胱术##腹腔镜盆腔淋巴结清扫术
左臂丛神经探查松解术	臂丛神经探查术##臂丛神经松解术
右髋关节穿刺活检术	骨盆活组织检查##关节穿刺术
右额叶胶质瘤切除+颅内压监护置入术	额叶病损切除术##颅内压监测
经十一肋右肾上腺及肿瘤切除	肾上腺病损切除术##单侧肾上腺切除术
彩色多普勒超声引导下右肩关节肌腱松解术+关节穿刺术	肩关节松解术##关节穿刺术
经尿道膀胱肿瘤绿激光汽化术（PVBt）+右侧输尿管双J管置入术	经尿道膀胱病损激光烧灼术##经尿道输尿管支架置入术
B超引导下前列腺穿刺+插入导尿管	留置导尿管的置入术##闭合性[经皮][针吸]前列腺活组织检查
左乳腺癌乳房单切加前哨淋巴结活检术	前哨淋巴结活组织检查##单侧单纯乳房切除术
ERCP+胰管支架置入术	内镜逆行胰胆管造影[ERCP]##胰管支架置入术
牙槽嵴裂植骨术+髂骨取骨术	牙槽嵴裂植骨术##髂骨切除术用作移植物
子宫下段剖宫产术+产钳助产术。	低位子宫下段剖宫产##低位产钳手术
宫颈锥切术+取环术	子宫内避孕器取出术##子宫颈锥形切除术
双侧腋臭切除，局部皮瓣成形术	腋嗅切除术##带蒂皮瓣或皮瓣移植
经皮椎体成形+活检术	椎骨活组织检查##经皮椎骨成形术
关节镜检查+前交叉韧带重建	关节镜膝关节检查##关节镜膝关节前交叉韧带重建术
腹腔镜下膀胱根治性切除术(+回肠导管术)	腹腔镜下膀胱根治切除术##小肠段分离术##可控回肠膀胱术
后路腰椎椎间盘髓核摘除、动态内固定术。	椎骨内固定术##腰椎髓核切除术
经腹左肾根治术，左肾上腺切除术	单侧肾切除术##单侧肾上腺切除术
左髋切开复位、骨盆和股骨截骨矫形内固定术	骨盆内固定术##骨盆楔形截骨术##髋脱位开放性复位术##股骨楔形骨切开术
左肾输尿管软镜碎石术+输尿管支架更换术	经尿道输尿管和肾盂梗阻去除##输尿管支架置换术
脑室腹腔分流术+颅骨修补术	颅成形术##侧脑室腹腔内分流术
(膀胱镜)前列腺等离子切除术+膀胱镜下钬激光碎石术	经尿道膀胱激光碎石术##经尿道前列腺切除术（TURP）
左肱骨髁上截骨矫形内固定术	肱骨内固定术##肱骨缩短手术
子宫下段剖宫产术+盆腔粘连松解术+手取胎盘术。	低位子宫下段剖宫产##盆腔粘连松解术##手法取出滞留的胎盘
左输尿管整形术+输尿管膀胱再植术	输尿管膀胱吻合术##输尿管成形术
TUR-P、耻骨上膀胱切开取石术	膀胱切开取石术##经尿道前列腺切除术（TURP）
右肾探查，右肾根治性切除术	肾探查术##单侧肾切除术
右股骨头髓芯减压、异体腓骨植入术	股骨减压术##腓骨切除术用作移植物##股骨移植术
膀胱镜下膀胱结石碎石取石术	经尿道膀胱取石术##经尿道膀胱清除术
右侧腮腺肿物及浅叶切除术+面神经解剖术	面神经解剖术##腮腺病损切除术##腮腺叶切除术
宫颈锥切+颈管搔刮术	子宫颈锥形切除术##子宫颈管搔刮术
活体亲属供肾移植术+腹透管拔除术	腹膜透析管去除##肾异体移植术##与供者有血缘关系的活体移植
右眼白内障超声乳化+人工晶体植入术	置入人工晶状体##白内障晶状体乳化和抽吸
左侧输尿管镜检查+碎石术	经尿道输尿管和肾盂梗阻去除##输尿管镜检查
膀胱全切术+回肠膀胱术	小肠段分离术##根治性膀胱切除术##可控回肠膀胱术
左侧输尿管镜探查+D-J管留置术	经尿道输尿管支架置入术##输尿管镜检查
左侧经皮肾镜碎石术（PCNL）+D-J管留置	经皮肾镜碎石术（PCNL）##经皮肾镜输尿管支架置入术
神经电生理监测下右翼点锁孔开颅动脉瘤夹闭术+颅骨成形术	颅成形术##钳夹动脉瘤
腮腺病损切除术+腮腺浅叶切除术+面神经解剖术+组织补片间置术	面神经解剖术##腮腺病损切除术##腮腺叶切除术##腮腺脱细胞异体真皮补片修补术
右侧舌下腺及囊肿摘除术	舌下腺切除术##舌下腺病损切除术
左跟腱断端吻合、长腿石膏托外固定术。	肌腱修补术##石膏托固定术
供体取肾术+供肾修整术+肾同种异体移植术+膀胱瓣代输尿管术	移植肾修补术##膀胱瓣代输尿管术##肾异体移植术##供肾取肾术
腹腔镜下双侧卵巢囊肿剥除术+盆腔粘连分解术	盆腔粘连松解术##腹腔镜卵巢病损切除术
腰椎内固定物取出+植骨术	椎骨植骨术##脊柱内固定装置去除术
子宫下段剖宫产术+子宫环形捆绑术。	低位子宫下段剖宫产##子宫捆绑术
牙槽突裂修复术+髂骨取骨术	牙槽嵴裂植骨术##髂骨切除术用作移植物
右眼PHACO、IOL植入、硅油取出术	置入人工晶状体##白内障晶状体乳化和抽吸##玻璃体硅油取出术
1.包皮环切术.2.阴茎病损切除术.3.阴茎延长术，4，阴茎矫直术5，阴茎建造术	阴茎矫直术##包皮环切术##阴茎延长术##阴茎病损切除术
腰椎椎板切除减压+腰椎间盘切除伴全椎板切除+椎弓根内固定术+后入路腰椎融合术+神经减压术+椎管探查术+2-3块椎骨融合+钛合金脊柱融合物置入术+腰椎植骨术	椎板切除减压术##2-3个椎骨融合或再融合##腰椎椎体间融合术，后入路##腰椎间盘切除术##脊神经根减压术##椎管探查术##椎体脊椎融合装置的置入
经皮穿刺腰1椎体成形术+活检术	椎骨活组织检查##经皮椎骨成形术
左髋切开复位＋左髋salter骨盆截骨+左股骨旋转截骨＋右股骨、右髂骨内固定取出术	股骨内固定装置去除术##骨盆楔形截骨术##髋脱位开放性复位术##股骨楔形骨切开术
经皮肾取石术+留置双J管术	经皮肾镜输尿管支架置入术##经皮肾镜取石术
腰后路腰椎肿瘤切除脊柱重建内固定术	椎骨病损切除术##椎骨内固定术
子宫下段剖宫产术+子宫肌瘤切除术	低位子宫下段剖宫产##子宫肌瘤切除术
椎间盘镜下后入路腰椎间盘切除术+神经减压术+椎管探查术	椎管探查术##腰椎椎体间融合术，后入路##内镜下腰椎间盘切除术
左股骨肿瘤刮除植骨内固定术	股骨内固定术##股骨病损切除术##股骨移植术
膝关节镜下前十字韧带重建术+副韧带修补术	关节镜膝关节前交叉韧带重建术##关节镜膝关节副韧带修补术
经皮肾结石激光碎石取石术	经皮肾镜激光碎石术##经皮肾镜取石术
1.附睾输精管吻合术（双）.2.睾丸病损切除术（双）.3.睾丸鞘膜切除翻转术（双,）4，睾丸固定术（双）	睾丸固定术##附睾输精管吻合术##睾丸鞘膜翻转术##睾丸病损切除术
经皮三叉神经半月节射频热凝术+经皮上颌神经干射频热凝术	三叉神经半月节射频热凝术##颅和周围神经的破坏术
1.经乙状窦后径路右侧听神经瘤摘除术  2.右腹部取脂术	自体脂肪移植术##经乙状窦后入路听神经瘤切除术
Quardrant通道下腰椎后路腰椎间盘摘除+椎管扩大减压神经根松解术	腰椎椎体间融合术，后入路##腰椎间盘切除伴椎管减压术
尿道扩张+输尿管镜检+输尿管支架管置入术	经尿道输尿管支架置入术##输尿管镜检查##尿道扩张
左髋切开复位＋左髋salter骨盆截骨+左股骨旋转截骨术	骨盆楔形截骨术##髋脱位开放性复位术##股骨楔形骨切开术
左侧翼点锁孔入路动脉瘤夹闭术+人工硬脑膜补片修补术+颅骨修补术	颅成形术##钳夹动脉瘤##硬脑膜补片修补术
右肾探查，右肾根治术	肾探查术##单侧肾切除术
子宫下段横切口剖宫产术+盆腔粘连松解术	盆腔粘连松解术##剖宫产术，子宫下段横切口
腹腔镜下膀胱根治性切除术+腹腔镜下附带阑尾切除术+回肠代膀胱术	腹腔镜下膀胱根治切除术##小肠段分离术##腹腔镜下附带阑尾切除术##可控回肠膀胱术
左侧基底节区血肿清除术+去骨瓣减压术+颅内压监护探头置入术。	颅骨去骨瓣减压术##颅内压监测##脑血肿切开引流术
剖腹探查止血术	腹腔出血止血术##开腹探查术
宫颈锥切术+成型术	子宫颈成形术##子宫颈锥形切除术
左侧乳腺包块切除术+左乳癌改良根治术	单侧乳腺改良根治术##乳房病损局部切除术
超声引导下右侧经皮肾镜钬激光碎石取石术	经皮肾镜激光碎石术##经皮肾镜取石术
阴茎下弯矫正术+尿道成形术	尿道成形术##阴茎矫直术
全膀胱切除+回肠膀胱术	小肠段分离术##根治性膀胱切除术##可控回肠膀胱术
经尿道前列腺电切术+尿道扩张术	经尿道前列腺切除术（TURP）##尿道扩张
蛙位石膏拆除并骨盆内固定拆除术	石膏外固定去除##骨盆内固定装置去除术
膀胱部分切除、左输尿管再植术	输尿管膀胱吻合术##部分膀胱切除术
左侧输尿管镜碎石取石术+留置输尿管支架术	经尿道输尿管和肾盂梗阻去除##经尿道输尿管支架置入术
腹腔镜下全子宫+双侧输卵管切除术	腹腔镜双侧输卵管切除术##腹腔镜经腹全子宫切除术
左髋切开复位、骨盆、股骨截骨术	骨盆楔形截骨术##髋脱位开放性复位术##股骨楔形骨切开术
阴茎下弯矫正+尿道成形术	尿道成形术##阴茎矫直术
Mathieu尿道成形+阴茎下弯矫直术	尿道成形术##阴茎矫直术
左乳切除+左腋窝前哨淋巴结活检术	前哨淋巴结活组织检查##单侧单纯乳房切除术
输尿管镜检查+扩张+置双J管术	经尿道输尿管支架置入术##输尿管镜检查##输尿管扩张术
(腹腔镜左侧)肾部分切除术+(左侧)腹腔镜下肾周或输尿管周围粘连的松解术((55.4001+59.0301))	腹腔镜下肾周或输尿管周围粘连的松解术##腹腔镜下肾部分切除术
左侧化疗泵置入+右侧脑室腹腔分流术	化疗泵置入术##侧脑室腹腔内分流术##颅腔或组织的导管置入术
(输尿管（或尿道）镜右侧)输尿管镜下取石术+输尿管镜下钬激光碎石术+输尿管镜检查术+输尿管扩张术+输尿管D-J管置入术((56.0001+56.0006+56.3101+59.8001+56.9201))	经尿道输尿管支架置入术##经尿道输尿管/肾盂激光碎石取石术##输尿管镜检查##输尿管扩张术
腹腔镜下双侧输卵管切除术+盆腔粘连松解术	盆腔粘连松解术##腹腔镜双侧输卵管切除术
脾切除+胆囊切除术	全脾切除术##胆囊切除术
乳房切除+腋窝前哨淋巴结活检术	乳房切除术##前哨淋巴结活组织检查
右乳癌保乳术+SLNB	前哨淋巴结活组织检查##单侧保乳乳腺改良根治术
腹腔镜膀胱根治性切除术+回肠尿流改道术	腹腔镜下膀胱根治切除术##输尿管-回肠吻合术
双侧脑深部电刺激植入术	脑深部电极置入术##颅神经刺激脉冲发生器植入
右额顶开颅脑膜瘤切除术+颅骨成形术	颅成形术##脑膜病损切除术
双侧扁桃体剥离术＋内窥镜下腺样体切除术	内镜下扁桃体切除术##内镜下腺样体切除术
全膀胱切除术+回肠膀胱术	小肠段分离术##根治性膀胱切除术##可控回肠膀胱术
左侧输尿管软镜钬激光碎石术+D-J管更换术	经尿道输尿管支架置入术##经尿道输尿管/肾盂激光碎石术
右尺骨鹰嘴、桡骨颈骨折切开复位内固定	尺骨骨折切开复位内固定术##桡骨骨折切开复位内固定术
鞍区病损切除+鞍底修补术	蝶鞍填塞##鞍区病损切除术
TURP+耻骨上膀胱造瘘术	经尿道前列腺切除术（TURP）##经皮膀胱造口术
经皮肾镜碎石术+输尿管支架管置入术（右）	经皮肾镜碎石术（PCNL）##经皮肾镜输尿管支架置入术
左眼白内障超声乳化吸出+人工晶体植入+前房形成术	置入人工晶状体##白内障晶状体乳化和抽吸##前房成形术
经尿道前列腺等离子电切术中转耻骨上经膀胱前列腺摘除术	经尿道前列腺切除术（TURP）##耻骨上经膀胱前列腺切除术
左侧输尿管镜检查+左侧经皮肾镜碎石术	经皮肾镜碎石术（PCNL）##输尿管镜检查
输尿管镜下气压弹道碎石术+双j管置入术	经尿道输尿管/肾盂气压弹道碎石术##经尿道输尿管支架置入术
右输尿管镜狭窄扩张，双J管内引流术	经尿道输尿管支架置入术##输尿管扩张术
选择性肝动脉造影+TACE术	经导管肝动脉栓塞术##动脉化疗栓塞
尿道憩室切除+尿道成形术	尿道成形术##尿道病损切除术
肝癌切除术+胆囊切除术	肝病损切除术##胆囊切除术
腹腔热灌注化疗术	注射或输注癌瘤化学治疗药物##腹膜腔注入局部作用的治疗性物质
CT引导肝肿瘤氩氦刀冷冻治疗术	肝病损冷冻治疗术##肝病损氩氦刀治疗术
膀胱结石碎石取石术	经尿道膀胱取石术##经尿道膀胱清除术
经尿道前列腺气化电切术[TEVAP手术]+经尿道膀胱镜碎石术	经尿道前列腺气化电切术[TEVAP手术]##经尿道膀胱清除术
左输尿管结石经尿道输尿管镜激光碎石术+左肾结石经尿道输尿管镜激光碎石术(软镜下)+左输尿管支架置入术	经尿道输尿管支架置入术##经尿道输尿管/肾盂激光碎石术
右尺神经探查松解前移术	尺神经松解术##尺神经移位术
左侧腕管综合征切开减压 + 正中神经松解术	腕管松解术##正中神经松解术
全膀胱切除术＋盆腔淋巴清扫+回肠膀胱术+阑尾切除术	小肠段分离术##根治性膀胱切除术##可控回肠膀胱术##阑尾切除术
颈椎后路寰枢椎融合术+取髂骨术	寰-枢椎融合术，后入路##髂骨切除术用作移植物
阴茎矫直术+尿道成形术+皮瓣修整术	尿道成形术##阴茎矫直术##转移皮瓣阴茎修补术
环形混合痔切除术、pph术	痔切除术##痔上直肠黏膜环形切除吻合术（PPH术）
右侧经皮肾镜气压弹道碎石取石术+双J管置入术。	经皮肾镜气压弹道碎石术##经皮肾镜输尿管支架置入术##经皮肾镜取石术
经尿道前列腺电切术+膀胱结石取出术	经尿道膀胱取石术##经尿道前列腺切除术（TURP）
跗骨、跖骨内固定取出术((78.6801))	跗骨内固定装置去除术##跖骨内固定装置去除术
左侧全髋关节置换术人工全髋关节置换术	髋关节置换修正术##全髋关节置换
经尿道右输尿管镜检查+双J管置入术	经尿道输尿管支架置入术##输尿管镜检查
化疗泵置入+脑室腹腔分流术	化疗泵置入术##侧脑室腹腔内分流术##颅腔或组织的导管置入术
左侧腮腺肿物切除术+面神经解剖术	面神经解剖术##腮腺病损切除术
左输尿管镜检+狭窄扩张术+DJ管置入术	经尿道输尿管支架置入术##输尿管镜检查##输尿管扩张术
经皮椎体后凸成形+椎体活检术	椎骨活组织检查##经皮椎体增强
经皮肾镜右肾结石碎石取石+内置双“J”管术	经皮肾镜碎石术（PCNL）##经皮肾镜输尿管支架置入术
左桡骨远端骨折切开复位钢板内固定术+左桡骨远端骨折切开复位螺钉内固定术+左桡骨远端骨折切开复位植骨术	桡骨骨折切开复位术##桡骨骨折切开复位内固定术##桡骨植骨术
肝动脉灌注化疗栓塞术。	经导管肝动脉栓塞术##动脉化疗栓塞
右股骨下段肿瘤瘤段切除膝关节人工假体置换术	全部膝关节置换##股骨病损切除术
膀胱镜碎石取石术	经尿道膀胱取石术##经尿道膀胱清除术
腹腔镜右侧多囊肾去顶减压+被膜剥脱术	肾包膜剥脱术##腹腔镜下肾囊肿去顶术
腹腔镜下根治性膀胱切除术+原位回肠膀胱术	腹腔镜下膀胱根治切除术##小肠段分离术##可控回肠膀胱术
尺神经松解术+尺神经移位术	尺神经松解术##尺神经移位术
腰椎后路L4椎板切除、L4/5椎间盘切除、椎间植骨融合内固定术	椎板切除减压术##腰椎椎体间融合术，后入路##腰椎间盘切除术
(腹腔镜)腹腔镜辅助阴道子宫切除术（LAVH）+(腹腔镜)腹腔镜下双侧输卵管卵巢切除术((68.5101+65.6301))	腹腔镜辅助阴道子宫切除术(LAVH)##腹腔镜双侧卵巢和输卵管切除术
左侧尺神经探查+尺神经松解、前置术	尺神经松解术##尺神经移位术##尺神经探查术
根治性全膀胱切除+回肠导管术	小肠段分离术##根治性膀胱切除术##可控回肠膀胱术
小脑蚓部髓母细胞瘤切除+右侧脑室枕角钻孔外引流+颅内压监护置入术	脑室钻孔引流术##颅内压监测##小脑蚓部病损切除术
1.经迷路径路左侧听神经瘤摘除术  2.右腹部取脂术	经迷路内听道听神经瘤切除术##自体脂肪移植术
(输尿管（或尿道）镜左侧)输尿管镜检查术+输尿管双“J”管取出术((56.3101+56.3101+97.6201+97.6201))	输尿管镜检查##输尿管双“J”管取出术
腰椎间盘髓核切除术+后入路腰椎融合术	腰椎椎体间融合术，后入路##腰椎髓核切除术
肩关节松解术+肩关节镜下滑膜切除术+肩关节镜下病损切除术+肩袖修补术+肩关节镜检查+肩峰成形术	关节镜肩关节检查##关节镜肩关节病损切除术##关节镜肩关节松解术##关节镜肩关节滑膜切除术##回旋肌环带修补术
左全髋置换术+骨泥植骨	骨空隙骨水泥填充术##全髋关节置换
右眼白内障超声乳化摘除+IOL植入术	置入人工晶状体##白内障晶状体乳化和抽吸
腹腔镜下左输尿管上段切开取石、置双J管术	腹腔镜下输尿管切开取石术##经尿道输尿管支架置入术
右侧人工耳蜗植入术、内耳开窗术	人工耳蜗置入术##内耳开窗术(初次)
宫腔镜检查+分段诊刮术+子宫内膜息肉摘除术	宫腔镜诊断性刮宫术##宫腔镜子宫内膜病损切除术
鞍区病损切除术+鞍底修补术	蝶鞍填塞##鞍区病损切除术
输尿管镜下碎石取石+输尿管支架管置入术	经尿道输尿管和肾盂梗阻去除##经尿道输尿管支架置入术
T12椎体活检+椎体成形术	椎骨活组织检查##经皮椎骨成形术
椎管内肿瘤切除术+椎骨内固定术	脊髓或脊膜病损的切除术或破坏术##椎骨内固定术
左锁骨下动脉支架置入术+左锁骨下动脉球囊扩张成形术+左锁骨下动脉造影	锁骨下动脉造影##锁骨下动脉球囊血管成形术##锁骨下动脉支架置入术
左侧脑室化疗泵置入+右侧脑室腹腔分流术	化疗泵置入术##侧脑室腹腔内分流术##颅腔或组织的导管置入术
左侧面神经微血管减压术+术中电生理监测	手术中神经生理监测##面神经微血管减压术
腹腔镜胆囊切除术+术中胆道造影	腹腔镜下胆道造影术##腹腔镜下胆囊切除术
L4/5经左侧椎间孔减压、椎体间融合、钉棒系统内固定术	2-3个椎骨融合或再融合##椎间孔减压术##腰椎椎体间融合术，后入路
腹腔镜下膀胱根治性切除术+腹腔镜下盆腔淋巴结根治性切除术+输尿管-回肠皮肤造口术+回肠部分切除术+输尿管-回肠吻合术+输尿管支架管置入术	腹腔镜下膀胱根治切除术##回肠部分切除术##腹腔镜盆腔淋巴结清扫术##回肠输尿管皮肤造口术
子宫下段横切口剖宫产术+右输卵管系膜囊肿摘除术	输卵管病损切除术##剖宫产术，子宫下段横切口
子宫下段剖宫产术+臀牵引术。	低位子宫下段剖宫产##臀位牵引
腹腔镜下左肾囊肿去顶减压术+肾周粘连分离术	肾周围粘连松解术##腹腔镜下肾囊肿去顶术
肾盂成形术+肾盂切开取石术	肾盂切开取石术##肾盂成形术
尿道成形术+阴茎矫直术手术方式及根据（若术式大于一种）：/	尿道成形术##阴茎矫直术
枕下入路小脑小脑蚓部肿瘤显微切除术+右侧脑室枕角穿刺外引流术	小脑蚓部病损切除术##脑池穿刺
右侧输尿管镜探查+输尿管狭窄球囊扩张术+D-J管留置术	经尿道输尿管支架置入术##输尿管镜检查##输尿管扩张术
右眼白内障摘除联合人工晶体置入术	置入人工晶状体##白内障晶状体乳化和抽吸
鼻内镜下腺样体切除术，双下甲部分切除术。	鼻甲部分切除术##内镜下腺样体切除术
右侧肾盂切开取石术+肾周粘连松解术	肾盂切开取石术##肾周围粘连松解术
输尿管镜检查术+留置输尿管支架术	经尿道输尿管支架置入术##输尿管镜检查
经尿道膀胱碎石取石术+经尿道前列腺剜除术	经尿道前列腺切除术##经尿道膀胱取石术##经尿道膀胱清除术
左髋关节切开复位+Pemberton骨盆截骨+股骨短缩旋转截骨术	骨盆楔形截骨术##髋脱位开放性复位术##股骨楔形骨切开术
腹腔镜双侧精索静脉高位结扎术+包皮环切术	腹腔镜精索静脉高位结扎术##包皮环切术
左眼超声乳化+IOL术	置入人工晶状体##白内障晶状体乳化和抽吸
输尿管镜下碎石术+留置双J管术 左侧	经尿道输尿管和肾盂梗阻去除##经尿道输尿管支架置入术
腹腔镜下全子宫+双附件切除术	腹腔镜双侧卵巢和输卵管切除术##腹腔镜经腹全子宫切除术
后腹腔镜下根治性左肾切除术+左输尿管全长切除术+膀胱袖口状切除术	腹腔镜下单侧肾输尿管切除术##膀胱袖状切除术
L4-5椎板切除减压、神经根松解、棘突间融合术	椎板切除减压术##2-3个椎骨融合或再融合##腰椎后柱融合术，后入路##脊神经根减压术
后路L4/L5椎间盘髓核摘除椎间植骨融合内固定术。	腰椎椎体间融合术，后入路##腰椎髓核切除术
输尿管镜检查术+取活检术	闭合性内镜下输尿管活组织检查##输尿管镜检查
左肱骨肿瘤切除重建内固定术	肱骨内固定术##肱骨病损切除术
鼻内镜下双侧上颌窦、筛窦开放术	内镜下上颌窦开窗术##内镜下额窦开窗术
经尿道前列腺电切+膀胱镜激光碎石术	经尿道膀胱激光碎石术##经尿道前列腺切除术（TURP）
腹腔镜探查 开腹全胃切除术	腹腔镜检查##胃全部切除术
四肢皮肤和皮下组织肿物切除术	皮下组织病损切除术##皮肤病损切除术
输尿管镜检查+置双J管	经尿道输尿管支架置入术##输尿管镜检查
皮肤恶性肿瘤切除术及任意皮瓣成形术。	皮肤病损切除术##带蒂皮瓣或皮瓣移植
亲属供肾同种异体肾移植术	肾异体移植术##与供者有血缘关系的活体移植
左肾部分切除（NSS）+左肾固定术	肾固定术##部分肾切除术
双侧脑深部电极置入术	脑深部电极置入术##颅神经刺激脉冲发生器植入
子宫下段剖宫产术+手取胎盘术。	低位子宫下段剖宫产##手法取出滞留的胎盘
左侧腮腺浅叶及肿块切除术	腮腺病损切除术##腮腺叶切除术
亲属同种异体肾移植术	肾异体移植术##与供者有血缘关系的活体移植
子宫下段剖宫产术+左侧输卵管系膜囊肿剥除术	低位子宫下段剖宫产##输卵管病损切除术
腹腔镜下右侧输卵管切除术+盆腔粘连松解术	腹腔镜单侧输卵管切除术##盆腔粘连松解术
右额脑室钻孔引流术+颅内神经刺激器置入术	脑室钻孔引流术##颅内神经刺激器植入术##颅神经刺激脉冲发生器植入
腰椎后路L4/5椎间盘切除+椎管扩大减压+椎体间骨移植+融合内固定+神经电生理监护术	2-3个椎骨融合或再融合##腰椎椎体间融合术，后入路##腰椎间盘切除伴椎管减压术##手术中神经生理监测
左输尿管镜碎石取石术，双J管内引流术	经尿道输尿管/肾盂取石术##经尿道输尿管支架置入术##经尿道输尿管/肾盂激光碎石术
左经输尿管镜弹道碎石术+左输尿管支架置入术	经尿道输尿管/肾盂气压弹道碎石术##经尿道输尿管支架置入术
膀胱镜钬激光碎石+TURP	经尿道膀胱激光碎石术##经尿道前列腺切除术（TURP）
剖腹探查+左肾切除术	单侧肾切除术##开腹探查术
阴茎下弯矫形、尿道成形术	尿道成形术##阴茎矫直术
经尿道膀胱病损电切术+经尿道膀胱血块清除术	经尿道膀胱病损切除术##经尿道膀胱血块清除术
右侧肋骨骨折切开复位内固定术+胸腔闭式引流术	肋骨骨折切开复位内固定术##胸腔闭式引流术
腹腔镜子宫全切术+双侧输卵管切除术	腹腔镜双侧输卵管切除术##腹腔镜经腹全子宫切除术
输尿管镜检查伴活组织检查	闭合性内镜下输尿管活组织检查##输尿管镜检查
右肾结石经皮肾镜气压弹道碎石取石术	经皮肾镜气压弹道碎石术##经皮肾镜取石术
右侧输尿管镜探查、扩张、置双J管术	经尿道输尿管支架置入术##输尿管镜检查##输尿管扩张术
右踝关节镜检+增生滑膜切除术	关节镜踝关节滑膜切除术##关节镜踝关节检查
右全髋关节置换+股骨转子间骨折内固定术	股骨骨折切开复位内固定术##全髋关节置换
左输尿管镜下气压弹道碎石术+左输尿管双J管置入术	经尿道输尿管/肾盂气压弹道碎石术##经尿道输尿管支架置入术
输尿管下钬激光碎石术加双J管置入术	经尿道输尿管支架置入术##经尿道输尿管/肾盂激光碎石术
(输尿管（或尿道）镜左侧)输尿管镜下取石术+(输尿管（或尿道）镜左侧)输尿管镜下钬激光碎石术+(输尿管（或尿道）镜左侧)输尿管D-J管置入术	经尿道输尿管/肾盂激光碎石取石术##经尿道输尿管支架置入术
左肩关节松解、关节腔内止痛术	关节治疗性物质注射##肩关节松解术
经皮肾镜碎石取石+输尿管支架管置入术	经皮肾镜碎石术（PCNL）##经皮肾镜输尿管支架置入术##经皮肾镜取石术
右眼白内障超声乳化吸除联合人工晶体植入术	置入人工晶状体##白内障晶状体乳化和抽吸
左肾根治性切除术+脾切除术	单侧肾切除术##全脾切除术
腹腔镜下双侧卵巢巧囊剥除+通液术	腹腔镜卵巢病损切除术##腹腔镜输卵管通液术
腹腔镜下肾部分切除术(右侧)+腹腔镜下肾囊肿去顶术(右侧)	腹腔镜下肾囊肿去顶术##部分肾切除术
L1椎体活检+椎体成形术	椎骨活组织检查##经皮椎骨成形术
输尿管镜下碎石术+输尿管置管术	经尿道输尿管和肾盂梗阻去除##经尿道输尿管支架置入术
根治性膀胱切除+回肠导管术	小肠段分离术##根治性膀胱切除术##可控回肠膀胱术
立体定向颅内血肿穿刺引流术+侧脑室穿刺引流术+ICP传感器置入术	颅内压监测##颅内穿刺引流术##脑池穿刺
回肠膀胱术	小肠段分离术##可控回肠膀胱术
阴茎伸直+尿道成形术	尿道成形术##阴茎矫直术
腹腔镜根治性全膀胱切除+直肠代膀胱+乙状结肠腹壁造口术	腹腔镜下膀胱根治切除术##乙状结肠膀胱腹壁造口术##直肠代膀胱术
异体肾移植术((55.6901)) +修肾术	移植肾修补术##肾异体移植术
经尿道膀胱肿瘤电切术+尿道扩张术	经尿道膀胱病损切除术##尿道扩张
